0000000000000000@
00000EEEECC00000@
0000EEEEEECC0000@
0000CCCCCCCC0000@
00EEEEEEEEEEEE00@
0EE6000000006EE0@
0E60E00E000006E0@
0060070070000600@
00000FE0FE000000@
00007EEEE7000000@
0000066660600000@
00006EEE66660000@
000C6EEE60C70000@
0007088880FF0000@
0000080088000000@
00000F000F000000@
$