TTTTT000000TTTTT@
TTTT0EEEE660TTTT@
TTT0EEEEEE660TTT@
TT004444444400TT@
T0EEEEEEEEEEEE0T@
0EE6000000006EE0@
0E606006000006E0@
T06007007000060T@
TT000F60F60000TT@
TTT066666600TTTT@
TTTT06666040TTTT@
TTT046E644440TTT@
TT064EEE40660TTT@
TT06099990660TTT@
TTT009009900TTTT@
TTTT060T060TTTTT@
$